1111111111
10000001C1
1000C00111
1001110001
1000000001
1111110001
1000PC0E01
1111111111
