111111111111111
110100000001001
1000000C0001C01
1C0001100001101
111101000D01001
101101111001001
1C000C1E1001001
1000C00000C00P1
111111111111111
