111111111111
100000000001
1000000001
100000000001
