1111111
1P00C01
0110E01
1000000
1111111
