1101111
100P001
1CCCC01
1E00001
1111011
