111111111111111
110100000000001
100000000000001
1C0001100000001
111101000000001
101101111000001
10000C1E1000001
1000000000000P1
111111111111111
