1111111111
1C01000001
10000C0001
1P00011111
1111010C01
1E01010001
1000000001
1111111111
