1111111111
1101000001
1000C00001
1P00011111
1111010001
1011010001
10000C0E01
1111111111
