1111111111
1101000001
1000C000C1
1000011111
1111010001
1011010001
1000PC0E01
1111111111
